NO ./assets/north.xpm
SO ./assets/south.xpm
WE ./assets/west.xpm
EA ./assets/east.xpm

F 220,100,0
C 225,30,0

                 11111111111111111111111111111111111111111111111111111111111111111111111111111111111111111111111111111111111111111111111111111111111111111111111111111111111
           111111000000000000000000000000000000000000000000000000000000000000000000000000000000000000000000000000000000000000000000000000000000000000000000000000000000000001
        1110000000000000000000000000000000000000000000000000000000000000000000000000000000000000000000000000000000000000000000000000000000000000000000000000000000000000000001
      1100000000000000000000000000000000000000000000000000000000000000000000000000000000000000000000000000000000000000000000000000000000000000000000000000000000000000000000001
     100000000000000000000000000000000000000000000000E00000000000000000000000000000000000000000000000000000000000000000000000000000000000000000000000000000000000000000000000001
    10000000000000000000000000000000000000000000000000000000000000000000000000000000000000000000000000000000000000000000000000000000000000000000000000000000000000000000000000001
   1000000000000000000000000000000000000000000000000000000000000000000000000000000000000000000000000000000000000000000000000000000000000000000000000000000000000000000000000000001
  100000000000000000000000000000000000000000000000000000000000000000000000000000000000000000000000000000000000000000000000000000000000000000000000000000000000000000000000000000001
  1000000000000000000000000000000000000000000000000000000000000000000000000000000000000000000000000000000000000000000000000000000000000000000000000000000000000000000000000000000001
 100000000000000000000000000000111111111111111111111111111111111111111111111111111111111111111111111111111111111111111111111111111111111111111111111111100000000000000000000000000001
 100000000000000000000000000001                                                                                                                         100000000000000000000000000001
100000000000000000000000000001                                                                                                                           100000000000000000000000000001
10000000000000000000000000001                                                                                                                             100000000000000000000000000001
1000000000000000000000000001                                               1111111111111111111111111111111111111111111111111111111111111                   100000000000000000000000000001
100000000000000000000000001                                               100000000000000000000000000000000000000000000000000000000000001                   10000000000000000000000000001
10000000000000000000000001                                               10000000000000000000000000000000000000000000000000000000000000001                   1000000000000000000000000001
1000000000000000000000001                                               1000000000000000000000000000000000000000000000000000000000000000001                  1000000000000000000000000001
1000000000000000000000001                                              100000000000000000000000000000000000000000000000000000000000000000001                 100000000000000000000000001
1000000000000000000000001                                             1000000000000000000000000000000000000000000000000000000000000000000001                 100000000000000000000000001
1000000000000000000000001                                            10000000000000000000111111111111111111111111111111111000000000000000001                 100000000000000000000000001
100000000000000000000001                                            100000000000000000001                                 100000000000000001                 100000000000000000000000001
100000000000000000000001                                           100000000000000000001                                   10000000000000001                 100000000000000000000000001
100000000000000000000001                                          100000000000000000001                                     1000000000000001                 100000000000000000000000001
100000000000000000000001                                         100000000000000000001                                       1000000000000001                10000000000000000000000001
100000000000000000000001                                        100000000000000000001                                        1000000000000001                 1000000000000000000000001
10000000000000000000001                                         100000000000000000001                                        1000000000000001                 1000000000000000000000001
10000000000000000000001                                         100000000000000000001                                        1000000000000001                 1000000000000000000000001
10000000000000000000001                                         100000000000000000001                                        1000000000000001                 1000000000000000000000001
10000000000000000000001                                         100000000000000000001                                        1000000000000001                 1000000000000000000000001
10000000000000000000001                                         100000000000000000001                                        1000000000000001                 1000000000000000000000001
10000000000000000000001                                         100000000000000000001                                        1000000000000001                 1000000000000000000000001
10000000000000000000001                                         100000000000000000001                                        1000000000000001                 1000000000000000000000001
10000000000000000000001                                         100000000000000000001                                        1000000000000001                 1000000000000000000000001
10000000000000000000001                                         100000000000000000001                                        1000000000000001                 100000000000000000000001
10000000000000000000001                                        100000000000000000001                                         1000000000000001                1000000000000000000000001
100000000000000000000001                                      100000000000000000001                                          1000000000000001                1000000000000000000000001
100000000000000000000001                                     100000000000000000001                                           1000000000000001                1000000000000000000000001
100000000000000000000001                                    100000000000000000001                                            1000000000000001                1000000000000000000000001
100000000000000000000001                                   100000000000000000001                                             10000000000000001              10000000000000000000000001
1000000000000000000000001                                 100000000000000000001                                              100000000000000001            100000000000000000000000001
1000000000000000000000001                                100000000000000000001                                               1000000000000000001          1000000000000000000000000001
1000000000000000000000001                               100000000000000000001                                                100000000000000000011111111110000000000000000000000000001
1000000000000000000000001                              100000000000000000001                                                 100000000000000000000000000000000000000000000000000000001
1000000000000000000000001                             100000000000000000001                                                  100000000000000000000000000000000000000000000000000000001
1000000000000000000000001                            100000000000000000001                                                   100000000000000000000000000000000000000000000000000000001
1000000000000000000000001                           100000000000000000001                                                    100000000000000000000000000000000000000000000000000000001
 10000000000000000000000111111111111111111111111111100000000000000000001                                                     100000000000000000000000000000000000000000000000000000001
  100000000000000000000000000000000000000000000000000000000000000000001                                                      100000000000000000000000000000000000000000000000000000001
   1000000000000000000000000000000000000000000000000000000000000000001                                                       10000000000000000000000000000000000000000000000000000001
    10000000000000000000000000000000000000000000000000000000000000001                                                         100000000000000000000000000000000000000000000000000001
     100000000000000000000000000000000000000000000000000000000000001                                                           1000000000000000000000000000000000000000000000000001
      1000000000000000000000000000000000000000000000000000000000001                                                             10000000000000000000000000000000000000000000011111
       10000000000000000000000000000000000000000000000000000000001                                                               10000000000000000000000000000000000000011111
        111111111111111111111111111111111111111111111111111111111                                                                 11111111111111111111111111111111111111