NO ./assets/north.xpm
SO ./assets/south.xpm
WE ./assets/west.xpm
EA ./assets/east.xpm

F 220,100,0
C 225,30,10

11111111111111111
10000000000000001
10111111111111101
100001        101
111101        101
   101        101
111101        101
100001        101
10111111111111101
100000000000000N1
11111111111111111