NO ./assets/north.xpm
SO ./assets/south.xpm
WE ./assets/west.xpm
EA ./assets/east.xpm

F 220,100,0
C 225,30,0

11111111111111111111111111111111111111111
10000000000000000000000000000000000000001
10000000000000000000000000000000000000001
10000000000000000000000000000000000000001
10000000000000000000000000000000000000001
10000000000111111111111111110000000000001111111
100000000001               10000000000000000001
100000000001               10000000000000000001
100000000001               10000000000000000001
100000000001               10000000000000000001
100000000001               10000000000000000001
100000000001               11111111111110000001
111000011111                           10000001
  100001                               10000001
  100001                               10000001
  100001                               10000001
  100001                               10000001
  100001                               10000001
  1000011111111111111111111111111111111100N0001
  100000000000000000000000000000000000000000001
  100000000000000000000000000000000000000000001
  100000000000000000000000000000000000000000001
  111111111111111111111111111111111111111111111